SPQ = "countries/SPQR.txt"
NRB = "countries/Narbonensia.txt"
TRC = "countries/Tarraconensia.txt"
BTC = "countries/Baetica.txt"
MAU = "countries/Mauritania.txt"
MRT = "countries/Alpes Maritimae.txt"
COT = "countries/Alpes Cottiae.txt"
ALP = "countries/Alpes.txt"
CAS = "countries/Corsica and Sardinia.txt"
SIC = "countries/Sicily.txt"
DLM = "countries/Dalmatia.txt"
IBE = "countries/Iberia.txt"
GAL = "countries/Gaul.txt"
BSQ = "countries/Basque.txt"
BRI = "countries/Britannia.txt"
DAL = "countries/Dal Riada.txt"
FRA = "countries/Francia.txt"
FRI = "countries/Frisia.txt"
RAE = "countries/Raetia.txt"
BUR = "countries/Burgundy.txt"
THU = "countries/Thuringia.txt"
AUS = "countries/Austrasia.txt"
SUE = "countries/Suebia.txt"
LAN = "countries/Langobardia.txt"
MAR = "countries/Marcomania.txt"
SIL = "countries/Silesia.txt"
POM = "countries/Pomerania.txt"
POL = "countries/Polania.txt"
DUN = "countries/Danube.txt"
VAN = "countries/Vandalia.txt"
GLC = "countries/Galicia.txt"
ILL = "countries/Illyria.txt"
VIS = "countries/Visigothi.txt"
OST = "countries/Ostrogothi.txt"
ROM = "countries/Romean Empire.txt"
LIT = "countries/Lithuania.txt"
PLS = "countries/Polesie.txt"
KIE = "countries/Kiev.txt"
SAR = "countries/Sarmatia.txt"
UNI = "countries/Finno-Slavic Union.txt"
FIN = "countries/Suomi.txt"
GOT = "countries/Gotland.txt"
NOR = "countries/Norway.txt"
JUT = "countries/Jutland.txt"
ENG = "countries/England.txt"
MAC = "countries/Macedonia.txt"
ATH = "countries/Athens.txt"
PAT = "countries/Patres.txt"
KAL = "countries/Kalamata.txt"
TRI = "countries/Tripolis.txt"
LAR = "countries/Larisa.txt"
IAN = "countries/Ianina.txt"
AGR = "countries/Agrinion.txt"
AVA = "countries/Avalona.txt"
KOZ = "countries/Kozani.txt"
CRE = "countries/Crete.txt"
RHO = "countries/Rhodes.txt"
GLT = "countries/Galatia.txt"
ARM = "countries/Armenia.txt"
KAR = "countries/Kartalinia.txt"
ALB = "countries/Albania.txt"
ALA = "countries/Alania.txt"